|%%%%%%%%%%%%%%%%%%%%%%%%%%%%%%%%%%%%%|
|_____________________________________|
|_____________________%%%%%%%%%@%%%%%%|
|_____________________________________|
|%%%%%%%%%%%%%%%%%%%%%%%%%___________%|
|_____________________________________|
|_____________________%%%%%%%%%%%%%%%%|
|_____________________________________|
|%%%%%%%%%%%%%%%%%%%%%%%%%___________%|
|_____________________________________|
|_____________________%%%%%%%%%%%%%%%%|
|_____________________________________|
|%%%%%%%%%%%%%%%%%%%%%%%%%___________%|
|_____________________________________|
|_____________________%%%%%%%%%%%%%%%%|
|_____________________________________|
|%%%%%%%%%%%%%%%%%%%%%%%%%___________%|
|_____________________________________|
|%%%%%%%%%%%%%%%%%%%%%%%%%%%%%%%%%%%%%|